################################################################################
#                                                                              #
#                                                                              #
################################################################################
#                                                                              #
#                                                                              #
#                                                                              #
#                                                                              #
#                                                                              #
#                                                                              #
#                                                                              #
#                                                                              #
#                                                                              #
#                                                                              #
#                        #                                                     #
#                                                                              #
#                                                                              #
#                                                                              #
#                          #######                                             #
#                  $        $$$$$#                                             #
#                          #$$$$$#                                             #
#                          #######        $                                    #
#                   $      % %   %                                             #
#                             @              $                                 #
################################################################################
