################################################################################
#                                                                              #
#                                                                              #
################################################################################
#                                                                              #
#                                                                              #
#                                                                              #
#                                                                              #
#                                                                              #
#                                                                              #
#                                                                              #
#                                               #                              #
#                                                                              #
#                                                                              #
#                        #                                                     #
#                                %                                             #
#                                                                              #
#                                                                              #
#                          #######        %                                    #
#                  $        $$$$$#                                             #
#                    $     #$$$$$#                                             #
#                      b   #######        $                                    #
#                   $$     g %   %                   %                         #
#             b               @        b     $                                 #
################################################################################
